000000010000000
000000010000000
000000010000000
000000000000000
000110000000000
000000000010001
000000000010001
000000000010000
111000000100000
100000000100000
100000000000000
000000000000000
000000000000000
000000000000111
000000000000000
000011100000000
000000100000000
000000000011000
000000000011000
000000000011000
