111211111111111
111211111111111
111211111111111
111111111211111
111111111221112
111111111111111
112111111111111
222111122111222
111111121111211
111111121111111
111111121111111
111111111111111
112111111111111
222111111111111
111111111111111
111111111111111
111111112221111
111111111112111
111111111112111
111111111112111